15 21
*********************
*                   *
* **** ******* **** *
*      *******      *
** ***         *** **
** *** *** *** *** **
   *** *     * ***   
** *** *     * *** **
** *** *     * *** **
*      *******      *
* ****         **** *
* **** ******* **** *
* **** ******* **** *
*                   *
*********************
