28 31
**************  ***************
*        *****  *, *    **    *
* *** ** ***,,  *,** ** ** ** *
* *** ** ***,*  ,,** **    ** *
* *** ** * ,,*  **** ***** ** *
* *** ** *****  **** ***** ** *
*                          ** *
* *** ********  **** ** ***** *
* *** ********  **** ** ***** *
* ***    **          **    ** *
* *** ** ** ***** ** ** ** ** *
* *** ** ** ,, ** ** ** ** ** *
*     **    ***** **    **    *
***** ***** **    ***** ***** *
***** ***** **    ***** ***** *
*     **    ***** **    **    *
* *** ** ** ***** ** ** ** ** *
* *** ** ** ***** ** ** ** ** *
* ***    **          **    ** *
* *** ********  **** ** ***** *
* *** ********  **** ** ***** *
*                          ** *
* *** ** *****  **** ***** ** *
* *** ** *****  * ,* ***** ** *
* *** ** ,,***  **,, **    ** *
* *** ** *,***  **** ** ** ** *
*        *, **  ****    **    *
**************  ***************
