31 28
**** ****************** ****
*            **            *
* **** ***** ** ***** **** *
* **** ***** ** ***** **** *
* **** ***** ** ***** **** *
*                          *
* **** ** ******** ** **** *
* **** ** ******** ** **** *
*      **    **    **      *
****** ***** ** ***** ******
     * ***** ** ***** *     
     * **          ** *     
     * ** ** ***** ** *     
****** ** *      * ** ******
          *      *          
****** ** *      * ** ******
     * ** ***** ** ** *     
     * **          ** *     
     * ** ******** ** *     
****** ** ******** ** ******
*            **            *
* **** ***** ** ***** **** *
* **** ***** ** ***** **** *
*   **                **   *
*** ** ** ******** ** ** ***
*** ** ** ******** ** ** ***
*      **    **    **      *
* ********** ** ********** *
* ********** ** ********** *
*                          *
**** ****************** ****
